{
  "Name": "Run for the Stairs!",
  "Controls": "",
  "Base": [0, 0, 0],
  "Size": [11, 7, 2],
  "Map": [
      1, 1, 1, 1, 1, 1, 1, 1, 1, 1, 1,
      1, 1, 1, 1, 1, 1, 1, 1, 1, 1, 1,
      1, 1, 1, 1, 1, 1, 1, 1, 1, 1, 1,
      1, 1, 1, 1, 1, 1, 1, 1, 1, 1, 1,
      1, 1, 1, 1, 1, 1, 1, 1, 1, 0, 1,
      1, 1, 1, 1, 1, 1, 1, 1, 1, 1, 1,
      1, 1, 1, 1, 1, 1, 1, 1, 1, 1, 1,

      1, 1, 1, 1, 1, 1, 1, 1, 1, 1, 1,
      1, 1, 0, 1, 0, 1, 1, 1, 0, 0, 1,
      1, 1, 1, 1, 0, 1, 1, 1, 1, 1, 1,
      1, 0, 0, 0, 0, 0, 0, 0, 0, 1, 1,
      1, 0, 0, 0, 0, 0, 0, 0, 0, 0, 1,
      1, 1, 1, 1, 1, 1, 1, 1, 1, 1, 1,
      1, 1, 1, 1, 1, 1, 1, 1, 1, 1, 1
    ],
  "Entities": [
    {
      "Position": [4, 1, 1],
      "Direction": [0, 1, 0],
      "Gravity": [0, 0, -1],
      "CounterValue": null,
      "CustomData": {
        "$Type": "Player"
      }
    },
    {
      "Position": [1, 3, 1],
      "Direction": [0, 1, 0],
      "Gravity": [0, 0, -1],
      "CounterValue": null,
      "CustomData": {
        "$Type": "Rock",
        "Type": "LineChase"
      }
    }
  ]
}