{
  "Name": "Rolling All Over",
  "Controls": "",
  "Base": [0, 0, 0],
  "Size": [13, 11, 2],
  "Map": [
      1, 1, 1, 1, 1, 1, 1, 1, 1, 1, 1, 1, 1,
      1, 1, 1, 1, 1, 1, 1, 1, 1, 1, 1, 1, 1,
      1, 1, 1, 1, 1, 1, 1, 1, 1, 1, 1, 1, 1,
      1, 1, 1, 1, 1, 1, 1, 1, 1, 1, 1, 1, 1,
      1, 1, 1, 1, 1, 1, 1, 1, 1, 1, 1, 1, 1,
      1, 1, 1, 1, 1, 1, 1, 1, 1, 1, 1, 1, 1,
      1, 1, 1, 1, 1, 1, 1, 1, 1, 1, 1, 1, 1,
      1, 1, 1, 1, 1, 1, 1, 1, 1, 1, 1, 1, 1,
      1, 1, 1, 1, 1, 1, 1, 1, 1, 1, 1, 1, 1,
      1, 1, 1, 1, 1, 1, 1, 1, 1, 1, 1, 1, 1,
      1, 1, 1, 1, 1, 1, 1, 1, 1, 1, 1, 1, 1,

      1, 1, 1, 1, 1, 1, 1, 1, 1, 1, 1, 1, 1,
      1, 1, 0, 0, 0, 0, 0, 0, 1, 0, 0, 0, 1,
      1, 1, 0, 0, 1, 0, 0, 0, 0, 0, 0, 0, 1,
      1, 1, 0, 0, 0, 0, 0, 0, 0, 0, 0, 0, 1,
      1, 0, 0, 0, 0, 0, 0, 0, 0, 0, 1, 0, 1,
      1, 1, 1, 1, 0, 0, 1, 0, 0, 0, 0, 0, 1,
      1, 1, 1, 0, 0, 0, 0, 0, 0, 0, 0, 0, 1,
      1, 0, 0, 0, 0, 0, 0, 0, 0, 0, 0, 0, 1,
      1, 0, 0, 0, 0, 0, 0, 0, 1, 0, 0, 0, 1,
      1, 0, 0, 0, 1, 0, 0, 0, 0, 0, 0, 0, 1,
      1, 1, 1, 1, 1, 1, 1, 1, 1, 1, 1, 1, 1
    ],
  "Entities": [
    {
      "Position": [5, 5, 1],
      "Direction": [0, -1, 0],
      "Gravity": [0, 0, -1],
      "CounterValue": null,
      "CustomData": {
        "$Type": "Player"
      }
    },
    {
      "Position": [1, 8, 1],
      "Direction": [0, 1, 0],
      "Gravity": [0, 0, -1],
      "CounterValue": null,
      "CustomData": {
        "$Type": "Rock",
        "Type": "LineChase"
      }
    },
    {
      "Position": [1, 4, 1],
      "Direction": [1, 0, 0],
      "Gravity": [0, 0, -1],
      "CounterValue": null,
      "CustomData": {
        "$Type": "Stairs"
      }
    },
    {
      "Position": [2, 4, 1],
      "Direction": [0, 1, 0],
      "Gravity": [0, 0, -1],
      "CounterValue": null,
      "CustomData": {
        "$Type": "Block",
        "Type": "Brittle"
      }
    }
  ]
}